R 1600 900
NO textures/NO.xpm
SO textures/SO.xpm
WE textures/WE.xpm
EA textures/EA.xpm
S  textures/S.xpm
F 40,38,
C 10,25,39

1111111111111111
12000000020000S1
1001000200000001
1000000100000001
1020000102000001
1000000000000001
1000001111100001
1000000000000001
1200000000000001
1111111111111111
